Islande : Reykjavik
Irlande : Dublin
Royaume-Uni : Londres
Norvège : Oslo
Suède : Stockholm
Finlande : Helsinki
Russie : Moscou
Estonie : Tallin
Lettonie : Riga
Lituanie : Vilnius
Biélorussie : Minsk
Ukraine : Kiev
Moldavie : Chisinau
Roumanie : Bucarest
Bulgarie : Sofia
Géorgie : Tbilissi
Turquie : Ankara
Chypre : Nicosie
Macédoine du Nord : Skopje
Kosovo : Pristina
Albanie : Tirana
Grèce : Athènes
Monténégro : Podgorica
Serbie : Belgrade
Bosnie-Herzégovine : Sarajevo
Croatie : Zagreb
Slovénie : Ljubljana
Hongrie : Budapest
Slovaquie : Bratislava
Pologne : Varsovie
République Tchèque : Prague
Allemagne : Berlin
Autriche : Vienne
Liechtenstein : Vaduz
Suisse : Berne
Italie : Rome
Saint-Marin : Saint-Marin
Vatican : Cité du Vatican
Malte : La Valette
France : Paris
Monaco : Monaco
Andorre : Andorre la Vieille
Espagne : Madrid
Portugal : Lisbonne
Belgique : Bruxelles
Luxembourg : Luxembourg
Pays-Bas : Amsterdam
Danemark : Copenhague
Baillage de Jersey : Saint-Hélier
Baillage de Guernesey : Saint-Pierre-Port